1111111111
1P00000001
100C00C001
1000E00001
1111111111