111111111111111111111111111111111111111111
1P0000000000C00000000000000000000000000001
1000000000000000000000000000000000000C0001
100010000010101111101000101111100100000001
100011000110101000001000101000000100000001
1000101010101010111010C0101111100100000001
10001001001010100C101000101000000100000001
100010000010101111101111101111100111100001
10000000000000000000000000C0000000000000E1
10000000000000000000000000000000000000C001
111111111111111111111111111111111111111111