1111111111111111111111111111111111111111
1P0000000000C000000000000000000000000001
1000000000000000000000000000000000000001
1000100000101011111010001011111010000001
1000110001101010000010001010000010000001
1000101010101010111010C01011111010000001
10001001001010100C1010001010000010000001
1000100000101011111011111011111011110001
10000000000000000000000000C00000000000E1
100000000000000000000000000000000000C001
1111111111111111111111111111111111111111